-6
10
0
8
00000000000000000
00000000011111110
00000000011111110
00000000011111110
00000000011111110
00000000011111110
10000000011111110
00000000011111110
00000000000000000
