-18
17
-10
9
111111111111111111111111111111111111
000000000000000000000000000000000000
000000000000000000000111111100000000
000000000000000000000111111100000000
000000000000000000000111111100000000
000000000000000000000111111100000000
000000000000000000000111111100000000
000000000000100000000111111100000000
000000000000000000000111111100000000
000000000000000000000000000000000000
000000000000000000000000000000000000
000000000000000000000000000000000000
000000000000000000000000000000000000
000000000000000000000000000000000000
000000000000000000000000000000000000
000000000000000000000000000000000000
000000000000000000000000000000000000
000000000000000000000000000000000000
000000000000000000000000000000000000
000000000000000000000000000000000000
